Rê NDM - Wtran, Cà Nâu
Yêu Đi - Châu Khải Phong
Điềm Xui - Daduc
Mashup We Don't Talk Anymore, Để Em Rời Xa (Biển Của Hy Vọng) - Đức Phúc, Tiên Cookie
Giữ Em Thật Lâu - Naod
Có Được Không Em Cover - Xuân Sâm
Đừng Bắt Em Phải Quên - Miu Lê
Thất Tình - Đức Phúc
Gió (Lofi) - Jank, 1 9 6 7
Lý Do Là Gì - Thái Học
Bụi Bay Vào Mắt - Đông Nhi
Anh Hứa Anh Không Khóc - Đang Cập Nhật
Ơ Vậy Là Yêu Chưa - MPacific, Ned D
Tàn Nhẫn (Lofi) - Lương Minh Trang
Bỗng Dưng Muốn Khóc - Phương Vy
Bức Tranh Phai Màu - Tăng Quỳnh My
Tìm (Biển Của Hy Vọng) - Phan Mạnh Quỳnh
Ừ Thì Thôi - T-PAME
Em Thật Là Ngốc Cover - Xuân Sâm
Only - Đức Phúc
Không Yêu Xin Đừng Nói (Speed Up) - UMIE
Giữ Em Đi - Đông Nhi, Hòa Minzy
Em Sẽ Quên - Hòa Minzy
Còn Em Anh Bỏ Cho Ai - LyLy Trần
Càng Hy Vọng Càng Thất Vọng - Phan Yến Nhi
Câu Chuyện Tình Yêu - Nhữ Thuỳ Dương
BLAME ON ME - FRANCO
Phận Tiên - Ice T
Cô Gái Quê - Diệu Kiên, Yuni Boo
Hôn Thật Lâu - Pháp Kiều
Cold Don't - Nmọc, Dmean, Astac
Chơi Vơi - Táo
Anh Yêu Em Nhiều Lắm - Đức Phúc
Cảm Ơn Mẹ - Trần Duy Hưng, Châu Khải Phong
Mưa Tháng Tư (Lofi Version) - VIET.
Giữa Cả Tỷ Người (Freak D Lofi Version) - Luke D, Tuấn Cry
Nhánh Hoa Hồng Dại - H-Kray
Em La Ai ? - NP.2
Dương Tính Với Thính - Tân Trần
Nuôi Ong Tay Áo - Ngọc Kara, Jombie
